111111111111111111111111
10000000000001000010c0e1
100000000000000000000001
10000000p0000000000c0001
100000000011111111000001
100000000110000000000001
100000011000000000000001
100001100000000000000001
100000011000000000000001
100000000110000000000001
111111111111111111111111
