1111111111111111111111111
1000000000000000000000001
1000000001111111000000001
1000001110011011110000001
1000011111100011100000001
1011110111111111111000001
1000011111111111111110001
1000000011111111111000001
1000000001111111110000001
1000000000111111110000001
1000000000011111111000001
1000000000001111111100001
10C0000000000011111110001
1000000000000000000P000E1
1111111111111111111111111