1111111111111111111111111
1000000000000000000000001
1000000001111111000000001
1000001110011011110000001
1000011111100011100000001
1011110111111111111000001
1000011111111111111110001
1000000011000000111000001
1000000001111111110000001
1000011000100000010000001
1000011000011111111000001
1000011000001111111100001
1000001001110010000010001
1000011001000101111110001
1000011001000000011110001
100001100C000100000111001
1000011001010000000011001
1000010010110100000001001
1000000000000000P000000E1
1111111111111111111111111
