11111111111111111111111111111111111111111111
100000000000CC000CC000000CCCCCC00000000000E1
100000000000CC000CC000000CC00CC0000000000001
100000000000CCCCCCC0000000C00C00000000000001
100000000000CCCCCCC0000000C00C00000000000001
100000000000CC000CC000000CC00CC0000000000001
1000000P0000CC000CC000000CCCCCC0000000000001
11111111111111111111111111111111111111111111