11111111111111111111111111111111111111111111
10000CCCCCCCCCC000000000000000000000000000E1
10000000000000000000000000000000000000000001
1000000000000CCCCCCCCCCCCCC00000000000000001
10000000000000000000000000000000000000000001
10000000000000CCCCCCCCCCCC000000000000000001
1000000P000000000000000000000000000000000001
11111111111111111111111111111111111111111111
